{
    "width": 7,
    "height": 7,
    "tiles": [
        4, 4, 4, 4, 4, 4, 4,
        2, 0, 0, 0, 0, 0, 4,
        4, 1, 0, 1, 1, 1, 4,
        4, 1, 0, 1, 1, 0, 3,
        4, 1, 0, 0, 1, 0, 4,
        4, 1, 0, 0, 0, 0, 4,
        4, 4, 4, 4, 4, 4, 4
    ]
}